000000000000000000,
000000000000000000,
000000000000000000,
000000000S00000000,
111111111111111111,
000000N0000000A000,
000000000000000000,
000000000000000000,
000000000000000000,
000000000000000000,
000000000000000000 