000000000000000000,
111000000000000000,
001000000000000000,
001000001111100000,
001000001000100000,
001000001000111111,
001111001000000000,
000001111000000000,
000000000000000000,
000000000000000000,
000000000000000000