000000000000000000,
111000000000000000,
0010000000S0000000,
001000001111100000,
001S00001ANA10A000,
001A00001000111111,
001111NS1000000000,
0000A1111000000000,
000000000000000000,
000000000000000000,
000000000000000000